HomePage
15 15
3 8
../../Dependencies/bmp/testTile2.bmp
100 50 5
0 0 0 0 0 0 0 0 0 0 0 0 0 0 0 
0 2 2 2 2 2 2 2 2 2 2 2 2 2 0 
0 2 0 0 0 0 0 0 0 0 0 0 0 2 0 
0 2 2 2 2 2 0 0 0 0 0 0 0 2 0 
0 0 0 0 0 2 0 0 0 0 0 0 0 2 0 
0 0 0 0 0 2 0 0 0 0 0 0 0 2 0 
0 2 2 2 0 0 0 0 0 0 0 0 0 2 0 
0 2 1 2 2 2 2 2 2 2 2 2 2 2 0 
0 2 2 2 0 0 0 2 0 0 0 0 0 0 0 
0 0 0 0 0 2 2 2 0 0 0 0 0 0 0 
0 0 0 0 0 2 0 2 0 0 0 0 0 0 0 
0 2 2 2 2 2 0 2 2 2 2 2 2 2 0 
0 2 0 0 0 2 0 0 0 0 0 0 0 2 0 
0 2 2 2 0 2 2 2 2 2 2 2 2 2 0 
0 0 0 0 0 0 0 0 0 0 0 0 0 0 0 